


111111
1P01E1
101101
10C001
111111


