


111111
10RE01
10R101
10C0P1
111111


