


111111
1P01E1
101101
10C0P1
111111


