


111111
100E01
100101
10C1P1
111111


