


111111
1P0101
101E01
110C01
111111



