


111111111111
100000CR00C1
100E000R1001
100P00000001
1C00R00R1001
111111111111


