


11111111111111111
100000CR00C11CR11
10000000100100011
100P0000E00100011
1000000R100110111
1C00R000000110111
1R000000100000001
1C00000R100000001
10000000100000001
11111111111111111


