




111111111111111111111111111111111111
100000CR00C1111110000000011111111111
1000000R100111111000C000010000000R11
100P0000E001000010000000010000R00011
1C00000R1001111110000000000000000R11
1C00R0000001111110000000000111111111
1R00000R1000000000000000000000000001
1C00000R1000000000000000000000000001
10000000100000000000C000000000000001
100000001000000000000000000000000001
100000001000000000000000000000000001
1000000010000000000000000000C0000001
100000001000000000000000000000000001
1C00R0001001111110000000011111111111
111111111111111111111111111111111111






