



111111
1001E1
1P0001
1CR1R1
1000C1
111111



